#########################
#                       #
#                       #
#  .                    #
#               .       #
#                       #
#                       #
#                       #
#                       #
#                       #
#                       #
#                     . #
#                       #
#            T          #
#                       #
#  .                    #
#                       #
#                       #
#                       #
#     .                 #
#                       #
#                       #
#                       #
#                       #
#            .          #
#########################
